#######################################
# EA      # S   S T    T    E  E     E#
#      T  # SSS   SSSS SSSS  S  S     #
#    T  S #  SSS  SSSS SSSS  S  #     #
#######S###   ###  # ## # ##### #    ##
# E    S   E      S #S S #S  S        #
#   T  S   SSSS   S #  S #      O A   #
#    T     SSSS   SSSS SSSS  S    T   #
#   T  S   SSSS   S #  S #        A   #
# E  T     SSSS   SSSS SSSS  S    T   #
#      SSSS SSS   SSSS SSSS SS       ##
#    T     SSSS   SSSS SSSS  S    T   #
#      SSSS SSS   SSSS SSSS SS       ##
# T    SSS   A     SSSS SSSS SS   S   #
#############A #SSSSSSSSS########SSSSS#
#       S          OO   OO     ##   S #
#   E   #   S   A             T #     #
#  ##########SS#####SSSS####SSSSS#    #
#    T  S   SSSSSSS  T S  T  T   #    #
# O   S  S SSSSSS               #  J ##
#  T  SSSS E SSSSS  E    E       #    #
#######################################
