###############################
#  A      # S   S T    E      #
#      T  # SSS   SSSS  S     #
#    T  S #  SSS  SSSS  #     #
#######S###   ###  # ### #    #
#      S   E      S #S        #
#   T  S   SSSS   S #     A   #
#    T     SSSS   SSSS        #
#      SSSS  SSS   SSSS       #
# T    SSS   A     SSSS   S   #
#############A ################
#       S                 S   #
#       #   S   A       S  S  #
#      S #   SSS          #   #
#  ##########SS############   #
#    T  S   SSSSSSS  T   #    #
#     S   S SSSSSS       #  J #
#  T  SSSS   SSSSS       #  A #
###############################
