############################################
#TTTTTTTTTOOOOOOEEEEEEOOOTTTTOOOOEEEOOOOEET#
#ETTTEEETT# OOOOOOOOOO SSSSATOOOOEEOO SSSS #
#EETTTTTTEEE  E EEESSS SSSSEESOOOSSSS SSSET#
###TTT   TT   EEEE  AEEEEE###  OOOO ## # ###
# E  TTTTTTT    TTTTTTTEEE  EEEEEEETTTTEEE #
#  TTT   EEEEEEEEEEEEEEETTTTTTTTT#  SEEE  T#
#  TTTT    SSSS   SSSS TTTTT    SSSS TTE TT#
#   T  S SS   S   S #  S #   S   S #  SE#  #
# E  TSSSSSSSSSSS SSSS SSSS  SSS SSSS SSSS #
#   SSS SOOO  SS  ASSS SSSS SSS   SSS SSSS##
#   A SSSSSSS  OOOSSSSSS SS   T  SSSS  A S #
#   SS SSSS   S SSSSSS SSSS SS SSSSSS SSSS##
# T SS SSSTT SSSS  SSSS    S SSSA SSSSEEEE #
#######   ###  #SSSSSSSSSSSSS #SSSSSSSSS##S#
#    SS S    SSSS  OO   OO SS   E OO   OO  #
#   E   # S S       SSSS   S  EE   EE E  A #
#  ##########SS#####SSSS####SS#####SSSS### #
# SSSS  S   SSSSSSS  T S  T  SSSSS  T S  T #
# O   S  S S  SSSSSS    A   A    SSSSSSS  ##
#J SS SSSS E  A  S  E    E   A  S  E    E  #
############################################
