############################################################################
#TTTTTTTTTOOOOOOOOOOOOOOOTTTTTTTTTTTTTTTTTTTTTTOOOOOOOOOOOOOOOEEEEEEEEEEEET#
# TTT   TT# OOOOOOOOOO SSSS TTEEEEEEEEEEEEEE TT# OOOOOOOOOO SSSS TTTTTTTTT #
#  TTTTTTEEEEEEEEEESSS SSSSEEEEEEEEEEEEEEEEETTTT  SSOOOSSSS SSSEEEEE   TTTT#
###TTT   TT   EEEEEEEEEEEE##### #   T###TTT   TT     OOOO ## # ##### #    ##
# E  TTTTTTT    TTTTTTTEEEEEEEEEEEET   E  TTTTTEEEEEEEEEETTTTEEEETTTTT T   #
#  TTT   EEEEEEEEEEEEEEEEETTT   TEEEEEEEEEEET TTSTTTTTTTT#  SEEEEEE  TTTTTT#
#  TTTT    SSSS   SSSS TTTTT S  AT   T TTTT   TSSSS   SSSS TTTTT S T  T   #
#   T  S SS   S   S #  S #   A EEEEEEEE  T  S SS   S   S #  S #   AT   A   #
# E  TSSSSSSSSSSS SSSS SSSS  S   EEEE  T  TSSSSSSSSSSS SSSS SSSS  S TT T   #
#   SSS  OOO  SS  ASSS SSSS SS  SSSS #A  SSS A     SS   SSS SSSS SS  SSSS ##
#   A SSSSSSS  OOOSSSSSS SS  S OO T      A SSSSSSS  T  SSSS  A S  S T  T   #
#   SS   SS   S SSSSSS SSSS SSSSSSSST#   SS   SS   S SSSSSS SSSS SSSSSS   ##
# T    SSSTT SSSS  SSSS    S SS   S    T    SSS   SSSS  SSSS    S SS   S   #
#######   ###A #SSSSSSSSSSSSS####SSSSS######   ###A #SSSSSSSSS########SSSSS#
#  A    S    SSSS  OO   OO SSSS##   S   A    S  T A     OO   OO     ##   S #
#   E   # S S   A   SSSS  AS  T #  A     E   #   S   A         A   T #  A  #
#  ##########SS#####SSSS####SSSSS#   A  ##########SS#####SSSS####SSSSS#    #
# SSSS  S   SSSSSSS  T S  T  T   #     SSSS  S   SSSSSSS  T S  T  T   #    #
# O   S  S S  SSSSSS    A   A   #  J # O   S  S S      SSSSSSS       #  J ##
#J SS SSSS E  A  S  E    E       #    J SS SSSS E  A  S  E    E       #    #
############################################################################
