#############################################################
#TTTTTTTTTOOOOOOOOOOOOOOOTTTTTTTOOOOOOOOOOOOOOOEEEEEEEEEEEET#
# TTT   TT# OOOOOOOOOO SSSS TTET# OOOOOOOOOO SSSS TTTTTTTTT #
#  TTTTTTEEEEEEEEEESSS SSSSEEEETT  SSOOOSSSS SSSEEEEE   TTTT#
###TTT   TT   EEEEEEEEEEEE#####TT     OOOO ## # ##### #    ##
# E  TTTTTTT    TTTTTTTEEEEEEEETEEEEEEEEEETTTTEEEETTTTT T   #
#  TTT   EEEEEEEEEEEEEEEEETTT  TTSTTTTTTTT#  SEEEEEE  TTTTTT#
#  TTTT    SSSS   SSSS TTTTT S TSSSS   SSSS TTTTT S T  T   #
#   T  S SS   S   S #  S #   A SS   S   S #  S #   AT   A   #
# E  TSSSSSSSSSSS SSSS SSSS  S SSSSSSSS SSSS SSSS  S TT T   #
#   SSS  OOO  SS  ASSS SSSS SS      SS   SSS SSSS SS  SSSS ##
#   A SSSSSSS  OOOSSSSSS SS  S SSSS  T  SSSS  A S  S T  T   #
#   SS   SS   S SSSSSS SSSS SSSSS   S SSSSSS SSSS SSSSSS   ##
# T    SSSTT SSSS  SSSS    S SSS   SSSS  SSSS    S SS   S   #
#######   ###A #SSSSSSSSSSSSS## ###A #SSSSSSSSS########SSSSS#
#  A    S    SSSS  OO   OO SSSS  T A     OO   OO     ##   S #
#   E   # S S   A   SSSS  AS  T   S   A         A   T #  A  #
#  ##########SS#####SSSS####SSS####SS#####SSSS####SSSSS#    #
# SSSS  S   SSSSSSS  T S  T  T    SSSSSSS  T S  T  T   #    #
# O   S  S S  SSSSSS    A   A  S S      SSSSSSS       #  J ##
#J SS SSSS E  A  S  E    E     S E  A  S  E    E       #    #
#############################################################
